111111111111111111111111111111111111111111111111111111111111
1P0000000000000000000001111111111110000000000000000000000001
100000000000000000011111111111111000000000000000000000000001
110000000000000000000001111111100000000000000000000000000001
111100000000000000000000001110000000000000000000000000000001
111111000001111000000001000000000000001111100010000100000001
100000000011111110000001000000000000001111111110000100000001
101111111111111111111110000000000000001111111111111111111111
100000000000000000000000000000000000001110000000000000000001
111111111100000011111111111000000000001110000000011110000001
1111111110000000000001110000000000000110000000010C111100C001
11110000100000000000000000C000000001111000000001000111100001
111000001000000000000000000000000000000000000001000011111111
110000000000000000000000001111111111111000000000000000111111
110000001111111111111111111111000000000000000000000011111111
11110000000000011111111111111111111111000000000C000011111111
111110000000000000001111111111111111111111111000111111111111
110000000000000000000000000000000000000000111011111111111111
110000000000000001111111111110000000000000000000000000111111
111110000C00000000000000000000000000000000000000000000011111
111111110000000000000000000000000000000000000000011111011111
111111111110000000000000000000000000000000000011111111001111
111111111111110000000000000000000000000000000111111111101111
1111111111111111100000000000000000000000000111111111111C1111
111111000000000000000000000C0000000000C000000000011111101111
111110000000000000000000001111111100000000000000000000000011
111111100000000000000000000111111100000000000000000000101111
111111111111110000000011111111111000000000000000000000000111
1111111111111111100000000000011111111110000000000000000E1111
111111111111111111111111111111111111111111111111111111111111
