111111111111111111111111111111
1P0000000000011111111110000001
100000000000111000000000C00001
1100000111100C1000000000000001
1110000001110111100000C0000111
100000000000001111110001110111
100110000000001100000000000111
1000110C0000000000000000001111
10C0111111110000000000000000E1
111111111111111111111111111111