111111111111111
1P00001110C0001
1000C0001000001
1111000C00000E1
111111111111111