111111111111111111111111111111
1P0000000000011111111111000001
10000000000011100000000C000001
10000001111C001000000000000001
10000000011101111C000000000111
100000000000001100000001110111
1000000000000010000E0000000111
100000C000000010000E0000001111
100000000000001C000000000000E1
111111111111111111111111111111
