111111111111111111111111111111
1P0000000000011111111110000001
100000000000111000000000000001
100000111110011100000000000001
111111C11110111100000C00000111
100000100000001100000001110111
100000000000001100000000000111
100000000000001100000000000111
1000000000000000000000000000E1
111111111111111111111111111111