111111111111111111111111111111
1P0000000000011111111110000001
100000000000111000000000000001
100000011110011100000000000001
1000000001110111100000C0000111
100000000000001100000001110111
100000000000001100000000000111
1000000C00000011000000C0001111
1111111011111100000000000000E1
111111111111111111111111111111
