111111111111111111111111111111
100000000000011111111110000001
100000000000011100000000000001
1000000111100C1000000000000001
1000000001110111100000C0000111
100000000000001100000001110111
100000000000001100000000000111
1000000C00000011000000C0001111
1000000000000000000000000001E1
111111111111111111111111111111
