111111111111111111111111111111111111111111111
1P0000000001111111111000000000000000000000001
11000000000001111100000000000000000C000000001
111000000000000111000000000000000000000000001
111100001000000000000000011111000100001000001
111111111111100000000000011111111111111111111
10000000000000C000011000000000000000000000001
111111111111000000011000000000011110000000001
1111111100000000C000000001110000100011100C001
1111000000000000000000000000C0000000111111111
111000000111111111111110000000000000011111111
11111000C00001111111111100000000000C001111111
111110000000000011111111111111000111111111111
11100000000000000000000000011111111111111
111000000001111111111000000000000000011111111
111110000C000000000000000000000000C0000000111
111111110000000000000000000000000111111111111
111111111110000000000C00000000E11111111111111
111111111111111111111111111111111111111111111