1111
1P01
1E01
1C011111111
1111